##### ##
#  ##  $#
# # #   #
### ### #
# # ### #
# # # # #
# # ### #
# #     #
# #######